R 1200 1200
NO ./textures/greystone.xpm
SO ./textures/colorstone.xpm
WE ./textures/eagle.xpm
EA ./textures/redbrick.xpm
S ./textures/barrel.xpm

C 0,191,255
F 255,255,255

11111111111111111111111111111
10000020001100000000000000001111111111111111111111111111111111111111
101100000111000000200000100000000000000000000000000000000000000000001
10010000000000111110000010000000111111110111111111111111111111111111
101100001111001   100000100000001      101
100020001 11001111110111100000001111111101
100000001 11110111000000100011111000000001
11100000111111011101010010001   1111111111
11110000011011011100000010001
10112020020000W10100000010001
10100000000000002101010010001
11110000000111110111011110001
11111111111110101111101111001
11111111111111111111111111111