R 1500 1100

NO ./textures/greystone.xpm
SO ./textures/colorstone.xpm
WE ./textures/eagle.xpm

EA ./textures/redbrick.xpm


S ./textures/barrel.xpm

T ./textures/trap.xpm

C 0,191,255
F 255,255,255


11111111111111111111111111111
100030200011000000000000000011111111111111
101100000111000000200000100000000000000001
100100000000001111100000100000001111111101
131100001111001   100000100000001      101
100020301 11001111110111100000001111111101
100000001 11110111000000100011111000000001
11130030111111011101010010001   1111111111
11110000011011411100000010001
10112020020000W10100000010001
10100333000000001101010010001
11113000300111111111011110001
11111111111110101111101111001
11111111111111111111111111111